... + .............................................................................................................................................
...   .............................................................................................................................................
...   .............................................................................................................................................
...   .............................................                        ........................................................................
...   .............................................                        ........................................................................
...   .............................................                        ........................................................................
...   .............................................   ..................   ........................................................................
...   .............................................   ..................   ........................................................................
...   .............................................   ..................   ........................................................................
...   .............................................   ..................   ........................................................................
...   .............................................   ..................   ........................................................................
...   .............................................   ..................   ........................................................................
...   .............................................   ..................   ........................................................................
...               ###                                 ..................                                                                          +
...               #M#                                 ..................                                                                          +
...               ###                                 ..................                                                                          +
...   .............................................   ..................   ........................................................................
...   .............................................   ..................   ........................................................................
...   .............................................   ..................   ........................................................................
...   .............................................   ..................   ........................................................................
...   .............................................   ..................   ........................................................................
...   .............................................   ..................   ........................................................................
...   .............................................   ..................   ........................................................................
...   .............................................   ..................   ........................................................................
...   .............................................   ..................   ........................................................................
...   .............................................                        ........................................................................
...   .............................................                        ........................................................................
...   .............................................                        .......................................................................
...   ............................................................................................................................................
...   ............................................................................................................................................
... + ............................................................................................................................................
