...................................................................................................................................................
...................................................................................................................................................
+                                                                                                                                               ...
+                                                                                                                                               ...
+                                                                                                                                               ...
.............................................................................................................................................   ...
.............................................................................................................................................   ...
.............................................................................................................................................   ...
.............................................................................................................................................   ...
.............................................................................................................................................   ...
.............................................................................................................................................   ...
.............................................................................................................................................   ...
.............................................................................................................................................   ...
.............................................................................................................................................   ...
.............................................................................................................................................   ...
.............................................................................................................................................   ...
.............................................................................................................................................   ...
.............................................................................................................................................   ...
.............................................................................................................................................   ...
.............................................................................................................................................   ...
.............................................................................................................................................   ...
.............................................................................................................................................   ...
.............................................................................................................................................   ...
.............................................................................................................................................   ...
.............................................................................................................................................   ...
.............................................................................................................................................   ...
.............................................................................................................................................   ...
.............................................................................................................................................###...
.............................................................................................................................................#M#...
.............................................................................................................................................###...
...................................................................................................................................................
