........................................................................   ........................................................................
........................................................................   ........................................................................
........................................................................   ........................................................................
............................................................                           ............................................................
...............                        .....................   .........   .........   ............................................................
...............                        .....................   .........   .........   ............................................................
...............                        .....................   .........   .........   ............................................................
...............   ..................   .....................   .........   .........   ............................................................
...............   ..................   .....................   .........   .........   ............................................................
...............   ..................   .....................   .........   .........   ............................................................
...............   ..................   .....................   .........   .........   ............................................................
...............   ..................   .....................   .........   .........   ............................................................
...............   ..................   .....................   .........   .........   ............................................................
                                                                                                                                                   
                                                                                                                                                   
                                                                                                                                                   
............................................................   .........   .........   .....................   ..................   ...............
............................................................   .........   .........   .....................   ..................   ...............
............................................................   .........   .........   .....................   ..................   ...............
............................................................   .........   .........   .....................   ..................   ...............
............................................................   .........   .........   .....................   ..................   ...............
............................................................   .........   .........   .....................   ..................   ...............
............................................................   .........   .........   .....................                        ...............
............................................................   .........   .........   .....................                        ...............
............................................................   .........   .........   .....................                        ...............
............................................................                           ............................................................
........................................................................   ........................................................................
........................................................................   ........................................................................
........................................................................   ........................................................................
........................................................................   ........................................................................
........................................................................   ........................................................................
