....................................................................   ............................................................................
....................................................................   ............................................................................
....................................................................   ............................................................................
........................................................                           ................................................................
...............                           ..............   .........   .........   ................................................................
...............                           ..............   .........   .........   ................................................................
...............                           ..............   .........   .........   ................................................................
...............   .....................   ..............   .........   .........   ................................................................
...............   .....................   ..............   .........   .........   ................................................................
...............   .....................   ..............   .........   .........   ................................................................
...............   .....................   ..............   .........   .........   ................................................................
...............   .....................   ..............   .........   .........   ................................................................
...............   .....................   ..............   .........   .........   ................................................................
                                                                    ###                                                                            
                                                                    #M#
                                                                    ### 
........................................................   .........   .........   ......................   .....................   ...............
........................................................   .........   .........   ......................   .....................   ...............
........................................................   .........   .........   ......................   .....................   ...............
........................................................   .........   .........   ......................   .....................   ...............
........................................................   .........   .........   ......................   .....................   ...............
........................................................   .........   .........   ......................   .....................   ...............
........................................................   .........   .........   ......................                           ...............
........................................................   .........   .........   ......................                           ...............
........................................................   .........   .........   ......................                           ...............
........................................................                           ................................................................
....................................................................   ............................................................................
....................................................................   ............................................................................
....................................................................   ............................................................................
....................................................................   ............................................................................
....................................................................   ............................................................................
