.....................................................................   ............................................................................
.....................................................................   ............................................................................
.....................................................................   ............................................................................
.........................................................                           ................................................................
...............                           ...............   .........   .........   ................................................................
...............                           ...............   .........   .........   ................................................................
...............                           ...............   .........   .........   ................................................................
...............   .....................   ...............   .........   .........   ................................................................
...............   .....................   ...............   .........   .........   ................................................................
...............   .....................   ...............   .........   .........   ................................................................
...............   .....................   ...............   .........   .........   ................................................................
...............   .....................   ...............   .........   .........   ................................................................
...............   .....................   ...............   .........   .........   ................................................................
                                                                     ###                                                                            
                                                                     #M#
                                                                     ### 
.........................................................   .........   .........   ......................   .....................   ...............
.........................................................   .........   .........   ......................   .....................   ...............
.........................................................   .........   .........   ......................   .....................   ...............
.........................................................   .........   .........   ......................   .....................   ...............
.........................................................   .........   .........   ......................   .....................   ...............
.........................................................   .........   .........   ......................   .....................   ...............
.........................................................   .........   .........   ......................                           ...............
.........................................................   .........   .........   ......................                           ...............
.........................................................   .........   .........   ......................                           ...............
.........................................................                           ................................................................
.....................................................................   ............................................................................
.....................................................................   ............................................................................
.....................................................................   ............................................................................
.....................................................................   ............................................................................
.....................................................................   ............................................................................
