..................................................................... + ...........................................................................
.....................................................................   ...........................................................................
.....................................................................   ...........................................................................
.........................................................                           ...............................................................
...............                           ...............   .........   .........   ...............................................................
...............                           ...............   .........   .........   ...............................................................
...............                           ...............   .........   .........   ...............................................................
...............   .....................   ...............   .........   .........   ...............................................................
...............   .....................   ...............   .........   .........   ...............................................................
...............   .....................   ...............   .........   .........   ...............................................................
...............   .....................   ...............   .........   .........   ...............................................................
...............   .....................   ...............   .........   .........   ...............................................................
...............   .....................   ...............   .........   .........   ...............................................................
+                                                                    ###                                                                          +
+                                                                    #M#                                                                          +
+                                                                    ###                                                                          +
.........................................................   .........   .........   ...............   .....................   .....................
.........................................................   .........   .........   ...............   .....................   .....................
.........................................................   .........   .........   ...............   .....................   .....................
.........................................................   .........   .........   ...............   .....................   .....................
.........................................................   .........   .........   ...............   .....................   .....................
.........................................................   .........   .........   ...............   .....................   .....................
.........................................................   .........   .........   ...............                           .....................
.........................................................   .........   .........   ...............                           .....................
.........................................................   .........   .........   ...............                           .....................
.........................................................                           ...............................................................
.....................................................................   ...........................................................................
.....................................................................   ...........................................................................
.....................................................................   ...........................................................................
..................................................................... + ...........................................................................
.....................................................................   ...........................................................................
