...   .............................................................................................................................................
...   .............................................................................................................................................
...   .............................................................................................................................................
...                            ·...................................................................................................................
...                            ....................................................................................................................
...                            ....................................................................................................................
............................   ....................................................................................................................
............................   ....................................................................................................................
............................   ....................................................................................................................
............................   ....................................................................................................................
............................   ....................................................................................................................
............................   ....................................................................................................................
............................   ....................................................................................................................
............................   .............................................................................  .....................................
............................                                         ###                                   ........................................
............................                                         #M#                                   ........................................
............................                                         ###                                   ........................................
............................   ....................................................................................................................
............................   ....................................................................................................................
............................   ....................................................................................................................
............................   ....................................................................................................................
............................   ....................................................................................................................
............................   ....................................................................................................................
............................   ....................................................................................................................
............................   ....................................................................................................................
...                            ....................................................................................................................
...                            ....................................................................................................................
...                            ....................................................................................................................
...   .............................................................................................................................................
...   .............................................................................................................................................
...   .............................................................................................................................................
