............................................................................................................   ....................................
............................................................................................................   ....................................
............................................................................................................   ....................................
............................................................................................................   ....................................
............................................................................................................   ....................................
............................................................................................................   ....................................
............................................................................................................   ....................................
............................................................................................................   ....................................
............................................................................................................   ....................................
.................................................                                                                                               ###
.................................................                                                                                               #M#
.................................................                                                                                               ###
.................................................   ........................................................   ....................................
.................................................   ........................................................   ....................................
.................................................   ........................................................   ....................................
.................................................   ........................................................   ....................................
.................................................   ........................................................   ....................................
.................................................   ........................................................   ....................................
.................................................   ........................................................   ....................................
.................................................   ........................................................   ....................................
.................................................   ........................................................   ....................................
                                                    ...............................................                    ............................
                                                    ...............................................                    ............................
                                                    ...............................................                    ............................
...................................................................................................   ..............   ............................
...................................................................................................   ..............   ............................
...................................................................................................   ..............   ............................
...................................................................................................   ..............   ............................
...................................................................................................   ..............   ............................
...................................................................................................   ..............   ............................
...................................................................................................   ..............   ............................
