...................................................................................................................................................
+                                                                                                                                               ...
+                                                                                                                                               ...
+                                                                                                                                               ...
............................................................................................................................................    ...
............................................................................................................................................    ...
............................................................................................................................................    ...
............................................................................................................................................    ...
............................................................................................................................................    ...
............................................................................................................................................    ...
............................................................................................................................................    ...
............................................................................................................................................    ...
............................................................................................................................................    ...
............................................................................................................................................    ...
............................................................................................................................................    ...
............................................................................................................................................    ...
............................................................................................................................................    ...
............................................................................................................................................    ...
............................................................................................................................................    ...
............................................................................................................................................    ...
..............................+++                                                                                                               ...
..............................+B+                                                                                                               ...
..............................+++                                                                                                               ...
...................................................................................................................................................
...................................................................................................................................................
...................................................................................................................................................
...................................................................................................................................................
...................................................................................................................................................
...................................................................................................................................................
...................................................................................................................................................
...................................................................................................................................................
