.....................................................................+++...........................................................................
.....................................................................   ...........................................................................
.....................................................................   ...........................................................................
.........................................................                           ...............................................................
...............                           ...............   .........   .........   ...............................................................
...............                           ...............   .........   .........   ...............................................................
...............                           ...............   .........   .........   ...............................................................
...............   .....................   ...............   .........   .........   ...............................................................
...............   .....................   ...............   .........   .........   ...............................................................
...............   .....................   ...............   .........   .........   ...............................................................
...............   .....................   ...............   .........   .........   ...............................................................
...............   .....................   ...............   .........   .........   ...............................................................
...............   .....................   ...............   .........   .........   ...............................................................                                                                               +++                                                                        
                                                                     +B+
                                                                     +++
.........................................................   .........   .........   ...............   .....................   .....................
.........................................................   .........   .........   ...............   .....................   .....................
.........................................................   .........   .........   ...............   .....................   .....................
.........................................................   .........   .........   ...............   .....................   .....................
.........................................................   .........   .........   ...............   .....................   .....................
.........................................................   .........   .........   ...............   .....................   .....................
.........................................................   .........   .........   ...............                           .....................
.........................................................   .........   .........   ...............                           .....................
.........................................................   .........   .........   ...............                           .....................
.........................................................                           ...............................................................
.....................................................................   ...........................................................................
.....................................................................   ...........................................................................
.....................................................................   ...........................................................................
.....................................................................   ...........................................................................
.....................................................................+++...........................................................................
