...................................................................................................................................................
...................................................................................................................................................
...................................................................................................................................................
...................................................................................................................................................
...................................................................................................................................................
                                                                             ......................................................................
                                                                             ......................................................................
                                                                             ......................................................................
..........................................................................   ......................................................................
..........................................................................   ......................................................................
..........................................................................   ......................................................................
                                                                                                                                    ...............
                                                                                                                                    ...............
                                                                                                                                    ...............
................................................................................................................................                ###
................................................................................................................................                #M#
................................................................................................................................                ###
                                                                                                                                    ...............
                                                                                                                                    ...............
                                                                                                                                    ...............
...........................................................................   .....................................................................
...........................................................................   .....................................................................
...........................................................................   .....................................................................
                                                                              .....................................................................
                                                                              .....................................................................
                                                                              .....................................................................
...................................................................................................................................................
...................................................................................................................................................
...................................................................................................................................................
...................................................................................................................................................
...................................................................................................................................................
