...................................................................................................................................................
                                                                                                                                                ...
                                                                                                                                                ...
                                                                                                                                                ...
............................................................................................................................................    ...
............................................................................................................................................    ...
............................................................................................................................................    ...
...                                                                                                                                      ...    ...
...                                                                                                                                      ...    ...
...                                                                                                                                      ...    ...
...    ...............................................................................................................................   ...    ...
...    ...............................................................................................................................   ...    ...
...    ...............................................................................................................................   ...    ...
...    ...                                                                                                                         ...   ...    ...
...    ...                                                                                                                         ...   ...    ...
...    ...                                                                                                                         ...   ...    ...
...    ...   ...................................................................................................................   ...   ...    ...
...    ...   ...................................................................................................................###...   ...    ...
...    ...   ...................................................................................................................#M#...   ...    ...
...    ...   ...................................................................................................................###...   ...    ...
...    ...   .........................................................................................................................   ...    ...
...    ...                                                                                                                               ...    ...
...    ...                                                                                                                               ...    ...
...    ...                                                                                                                               ...    ...
...    .....................................................................................................................................    ...
...    .....................................................................................................................................    ...
...    .....................................................................................................................................    ...
...                                                                                                                                             ...
...                                                                                                                                             ...
...                                                                                                                                             ...
...................................................................................................................................................
