...................................................................................................................................................
...................................................................................................................................................
...................................................................................................................................................
................................................................................................                                                ###
................................................................................................                                                #M#
................................................................................................                                                ###
................................................................................................   ................................................
................................................................................................   ................................................
................................................................................................   ................................................
..................................................                                                 ................................................
..................................................                                                 ................................................
..................................................                                                 ................................................
..................................................   ...........................................   ................................................
..................................................   ...........................................   ................................................
..................................................   ...........................................   ................................................
..................................................                                                 ................................................
..................................................                                                 ................................................
..................................................                                                 ................................................
..................................................   ...........................................   ................................................
..................................................   ...........................................   ................................................
..................................................   ...........................................   ................................................
                                                     ...........................................   ................................................
                                                     ...........................................   ................................................
                                                     ...........................................   ................................................
................................................................................................   ................................................
................................................................................................   ................................................
................................................................................................   ................................................
................................................................................................   ................................................
................................................................................................   ................................................
................................................................................................   ................................................
................................................................................................   ................................................
