...................................................................................................................................................
                                                                                                                                                ...
                                                                                                                                                ...
                                                                                                                                                ...
.............................................................................................................................................   ...
.............................................................................................................................................   ...
.............................................................................................................................................   ...
.............................................................................................................................................   ...
.............................................................................................................................................   ...
.............................................................................................................................................   ...
.............................................................................................................................................   ...
.............................................................................................................................................   ...
.............................................................................................................................................   ...
.............................................................................................................................................   ...
.............................................................................................................................................   ...
.............................................................................................................................................   ...
.............................................................................................................................................   ...
.............................................................................................................................................   ...
.............................................................................................................................................   ...
.............................................................................................................................................   ...
..............................###                                                                                                               ...
..............................#M#                                                                                                               ...
..............................###                                                                                                               ...
...................................................................................................................................................
...................................................................................................................................................
...................................................................................................................................................
...................................................................................................................................................
...................................................................................................................................................
...................................................................................................................................................
...................................................................................................................................................
