...................................................................................................................................................
+                                                                                                                                               ...
+                                                                                                                                               ...
+                                                                                                                                               ...
............................................................................................................................................    ...
............................................................................................................................................    ...
............................................................................................................................................    ...
............................................................................................................................................    ...
............................................................................................................................................    ...
............................................................................................................................................    ...
............................................................................................................................................    ...
............................................................................................................................................    ...
............................................................................................................................................    ...
............................................................................................................................................    ...
............................................................................................................................................    ...
............................................................................................................................................    ...
............................................................................................................................................    ...
............................................................................................................................................    ...
............................................................................................................................................    ...
............................................................................................................................................    ...
..............................###                                                                                                               ...
..............................#M#                                                                                                               ...
..............................###                                                                                                               ...
...................................................................................................................................................
...................................................................................................................................................
...................................................................................................................................................
...................................................................................................................................................
...................................................................................................................................................
...................................................................................................................................................
...................................................................................................................................................
...................................................................................................................................................
