...................................................................................................................................................
...................................................................................................................................................
...................................................................................................................................................
...................................................................................................................................................
...................................................................................................................................................
+                                                                            ......................................................................
+                                                                            ......................................................................
+                                                                            ......................................................................
..........................................................................   ......................................................................
..........................................................................   ......................................................................
..........................................................................   ......................................................................
+                                                                                                                                   ...............
+                                                                                                                                   ...............
+                                                                                                                                   ...............
................................................................................................................................                ###
................................................................................................................................                #M#
................................................................................................................................                ###
+                                                                                                                                   ...............
+                                                                                                                                   ...............
+                                                                                                                                   ...............
...........................................................................   .....................................................................
...........................................................................   .....................................................................
...........................................................................   .....................................................................
+                                                                             .....................................................................
+                                                                             .....................................................................
+                                                                             .....................................................................
...................................................................................................................................................
...................................................................................................................................................
...................................................................................................................................................
...................................................................................................................................................
...................................................................................................................................................
