...   .............................................................................................................................................
...   .............................................................................................................................................
...   .............................................................................................................................................
...   ..............................................                        .......................................................................
...   ..............................................                        .......................................................................
...   ..............................................                        .......................................................................
...   ..............................................   ..................   .......................................................................
...   ..............................................   ..................   .......................................................................
...   ..............................................   ..................   .......................................................................
...   ..............................................   ..................   .......................................................................
...   ..............................................   ..................   .......................................................................
...   ..............................................   ..................   .......................................................................
...   ..............................................   ..................   .......................................................................
...               ###                                  ..................   
...               #M#                                  ..................   
...               ###                                  ..................   
...   ..............................................   ..................   .......................................................................
...   ..............................................   ..................   .......................................................................
...   ..............................................   ..................   .......................................................................
...   ..............................................   ..................   .......................................................................
...   ..............................................   ..................   .......................................................................
...   ..............................................   ..................   .......................................................................
...   ..............................................   ..................   .......................................................................
...   ..............................................   ..................   .......................................................................
...   ..............................................   ..................   .......................................................................
...   ..............................................                        .......................................................................
...   ..............................................                        .......................................................................
...   ..............................................                        .......................................................................
...   .............................................................................................................................................
...   .............................................................................................................................................
...   .............................................................................................................................................
