...   .......................................................................................................................................   ...
...   .......................................................................................................................................   ...
...   .......................................................................................................................................   ...
...                            ·...........................................................................                                     ...
...                            ............................................................................                                     ...
...                            ............................................................................                                     ...
............................   ............................................................................   .....................................
............................   ............................................................................   .....................................
............................   ............................................................................   .....................................
............................   ............................................................................   .....................................
............................   ............................................................................   .....................................
............................   ............................................................................   .....................................
............................   ............................................................................   ....................................
............................   ............................................................................   .....................................
............................                                         ###                                      .....................................
............................                                         #M#                                      .....................................
............................                                         ###                                      .....................................
............................   ............................................................................   .....................................
............................   ............................................................................   .....................................
............................   ............................................................................   .....................................
............................   ............................................................................   .....................................
............................   ............................................................................   .....................................
............................   ............................................................................   .....................................
............................   ............................................................................   .....................................
............................   ............................................................................   .....................................
...                            ............................................................................                                     ...
...                            ............................................................................                                     ...
...                            ............................................................................                                     ...
...   .......................................................................................................................................   ...
...   .......................................................................................................................................   ...
...   .......................................................................................................................................   ...
