...................................................................................................................................................
....................................................................   ............................................................................
....................................................................   ............................................................................
........................................................                           ................................................................
........................................................   .........   .........   ................................................................
........................................................   .........   .........   ................................................................
........................................................   .........   .........   ................................................................
........................................................   .........   .........   ................................................................
........................................................   .........   .........   ................................................................
........................................................   .........   .........   ................................................................
........................................................   .........   .........   ................................................................
........................................................   .........   .........   ................................................................
........................................................   .........   .........   ................................................................
                                                                    ###                                                                            
                                                                    #M#
                                                                    ### 
........................................................   .........   .........   ................................................................
........................................................   .........   .........   ................................................................
........................................................   .........   .........   ................................................................
........................................................   .........   .........   ................................................................
........................................................   .........   .........   ................................................................
........................................................   .........   .........   ................................................................
........................................................   .........   .........   ................................................................
........................................................   .........   .........   ................................................................
........................................................   .........   .........   ................................................................
........................................................                           ................................................................
....................................................................   ............................................................................
....................................................................   ............................................................................
....................................................................   ............................................................................
....................................................................   ............................................................................
....................................................................   ............................................................................
