...+++.............................................................................................................................................
...   .............................................................................................................................................
...   .............................................................................................................................................
...   .............................................                        ........................................................................
...   .............................................                        ........................................................................
...   .............................................                        ........................................................................
...   .............................................   ..................   ........................................................................
...   .............................................   ..................   ........................................................................
...   .............................................   ..................   ........................................................................
...   .............................................   ..................   ........................................................................
...   .............................................   ..................   ........................................................................
...   .............................................   ..................   ........................................................................
...   .............................................   ..................   ........................................................................
...               +++                                 ..................                                                                          +
...               +B+                                 ..................                                                                          + 
...               +++                                 ..................                                                                          +
...   .............................................   ..................   ........................................................................
...   .............................................   ..................   ........................................................................
...   .............................................   ..................   ........................................................................
...   .............................................   ..................   ........................................................................
...   .............................................   ..................   ........................................................................
...   .............................................   ..................   ........................................................................
...   .............................................   ..................   ........................................................................
...   .............................................   ..................   ........................................................................
...   .............................................   ..................   ........................................................................
...   .............................................                        ........................................................................
...   .............................................                        ........................................................................
...   .............................................                        ........................................................................
...   .............................................................................................................................................
...   .............................................................................................................................................
...+++.............................................................................................................................................
