...................................................................................................................................................
...................................................................................................................................................
...................................................................................................................................................
................................................................................................                                                ###
................................................................................................                                                +B+
................................................................................................                                                ###
................................................................................................   ................................................
................................................................................................   ................................................
................................................................................................   ................................................
..................................................                                                 ................................................
..................................................                                                 ................................................
..................................................                                                 ................................................
..................................................   ...........................................   ................................................
..................................................   ...........................................   ................................................
..................................................   ...........................................   ................................................
..................................................                                                 ................................................
..................................................                                                 ................................................
..................................................                                                 ................................................
..................................................   ...........................................   ................................................
..................................................   ...........................................   ................................................
..................................................   ...........................................   ................................................
+                                                    ...........................................   ................................................
+                                                    ...........................................   ................................................
+                                                    ...........................................   ................................................
................................................................................................   ................................................
................................................................................................   ................................................
................................................................................................   ................................................
................................................................................................   ................................................
................................................................................................   ................................................
................................................................................................   ................................................
................................................................................................+++................................................
