.....................................................................   ...........................................................................
.....................................................................   ...........................................................................
.....................................................................   ...........................................................................
.........................................................                           ...............................................................
...............                           ...............   .........   .........   ...............................................................
...............                           ...............   .........   .........   ...............................................................
...............                           ...............   .........   .........   ...............................................................
...............   .....................   ...............   .........   .........   ...............................................................
...............   .....................   ...............   .........   .........   ...............................................................
...............   .....................   ...............   .........   .........   ...............................................................
...............   .....................   ...............   .........   .........   ...............................................................
...............   .....................   ...............   .........   .........   ...............................................................
...............   .....................   ...............   .........   .........   ...............................................................
                                                                     ###                                                                            
                                                                     #M#
                                                                     ### 
.........................................................   .........   .........   ......................   .....................   ..............
.........................................................   .........   .........   ......................   .....................   ..............
.........................................................   .........   .........   ......................   .....................   ..............
.........................................................   .........   .........   ......................   .....................   ..............
.........................................................   .........   .........   ......................   .....................   ..............
.........................................................   .........   .........   ......................   .....................   ..............
.........................................................   .........   .........   ......................                           ..............
.........................................................   .........   .........   ......................                           ..............
.........................................................   .........   .........   ......................                           ..............
.........................................................                           ...............................................................
.....................................................................   ...........................................................................
.....................................................................   ...........................................................................
.....................................................................   ...........................................................................
.....................................................................   ...........................................................................
.....................................................................   ...........................................................................
