...................................................................................................................................................
...................................................................................................................................................
...................................................................................................................................................
....................................................                        .......................................................................
....................................................                        .......................................................................
....................................................                        .......................................................................
....................................................   ..................   .......................................................................
....................................................   ..................   .......................................................................
....................................................   ..................   .......................................................................
....................................................   ..................   .......................................................................
....................................................   ..................   .......................................................................
....................................................   ..................   .......................................................................
....................................................   ..................   .......................................................................
.........###                                           ..................   
.........#M#                                           ..................   
.........###                                           ..................   
....................................................   ..................   .......................................................................
....................................................   ..................   .......................................................................
....................................................   ..................   .......................................................................
....................................................   ..................   .......................................................................
....................................................   ..................   .......................................................................
....................................................   ..................   .......................................................................
....................................................   ..................   .......................................................................
....................................................   ..................   .......................................................................
....................................................   ..................   .......................................................................
....................................................                        .......................................................................
....................................................                        .......................................................................
....................................................                        .......................................................................
...................................................................................................................................................
...................................................................................................................................................
...................................................................................................................................................
...................................................................................................................................................
