...................................................................................................................................................
+                                                                                                                                               ...
+                                                                                                                                               ...
+                                                                                                                                               ...
............................................................................................................................................    ...
............................................................................................................................................    ...
............................................................................................................................................    ...
...                                                                                                                                      ...    ...
...                                                                                                                                      ...    ...
...                                                                                                                                      ...    ...
...    ..............................................    .............................................................................   ...    ...
...    ..............................................    .............................................................................   ...    ...
...    ..............................................    .............................................................................   ...    ...
...    ..............................................    .............................................................................   ...    ...
...    ..............................................    .............................................................................   ...    ...
...    ..............................................    .............................................................................   ...    ...
...    ..............................................    .............................................................................   ...    ...
...    ..............................................    .............................................................................   ...    ...
...    ..............................................    .............................................................................   ...    ...
...    ..............................................    .............................................................................   ...    ...
...    ..............................................    .............................................................................   ...    ...
...    ..............................................                                                                                 ###...    ...
...    ..............................................                                                                                 +B+...    ...
...    ..............................................                                                                                 ###...    ...
...    .....................................................................................................................................    ...
...    .....................................................................................................................................    ...
...    .....................................................................................................................................    ...
...                                                                                                                                             ...
...                                                                                                                                             ...
...                                                                                                                                             ...
...................................................................................................................................................
