...................................................................................................................................................
...................................................................................................................................................
......................                                                                              ...............................................
......................                                                                              ...............................................
......................                                                                              ...............................................
......................   ........................................................................   ...............................................
......................   ........................................................................   ...............................................
......................   ........................................................................   ...............................................
......................   ...............                                                            ...............................................
......................   ...............                                                            ...............................................
......................   ...............                                                            ...............................................
......................   ...............   ........................................................................................................
......................   ...............   ........................................................................................................
......................   ...............   ........................................................................................................
......................   ...............                                                                                                        ###
......................   ...............                                                                                                        #M#
......................   ...............                                                                                                        ###
......................   ..........................................................................................................................
......................   ..........................................................................................................................
......................   ..........................................................................................................................
......................                                                        .....................................................................
......................                                                        .....................................................................
......................                                                        .....................................................................
...........................................................................   .....................................................................
...........................................................................   .....................................................................
...........................................................................   .....................................................................
...........................................................................   .....................................................................
...........................................................................   .....................................................................
...........................................................................   .....................................................................
...........................................................................   .....................................................................
...........................................................................+++.....................................................................
