...................................................................................................................................................
                                                                                                                                                ...
                                                                                                                                                ...
                                                                                                                                                ...
............................................................................................................................................    ...
............................................................................................................................................    ...
............................................................................................................................................    ...
............................................................................................................................................    ...
............................................................................................................................................    ...
............................................................................................................................................    ...
............................................................................................................................................    ...
............................................................................................................................................    ...
............................................................................................................................................    ...
............................................................................................................................................    ...
............................................................................................................................................    ...
............................................................................................................................................    ...
............................................................................................................................................    ...
............................................................................................................................................    ...
............................................................................................................................................    ...
............................................................................................................................................    ...
..............................###                                                                                                               ...
..............................#M#                                                                                                               ...
..............................###                                                                                                               ...
...................................................................................................................................................
...................................................................................................................................................
...................................................................................................................................................
...................................................................................................................................................
...................................................................................................................................................
...................................................................................................................................................
...................................................................................................................................................
