...   .............................................................................................................................................
...   .............................................................................................................................................
...   .............................................................................................................................................
...   .............................................                        ........................................................................
...   .............................................                        ........................................................................
...   .............................................                        ........................................................................
...   .............................................   ..................   ........................................................................
...   .............................................   ..................   ........................................................................
...   .............................................   ..................   ........................................................................
...   .............................................   ..................   ........................................................................
...   .............................................   ..................   ........................................................................
...   .............................................   ..................   ........................................................................
...   .............................................   ..................   ........................................................................
...               ###                                 ..................   
...               #M#                                 ..................   
...               ###                                 ..................   
...   .............................................   ..................   ........................................................................
...   .............................................   ..................   ........................................................................
...   .............................................   ..................   ........................................................................
...   .............................................   ..................   ........................................................................
...   .............................................   ..................   ........................................................................
...   .............................................   ..................   ........................................................................
...   .............................................   ..................   ........................................................................
...   .............................................   ..................   ........................................................................
...   .............................................   ..................   ........................................................................
...   .............................................                        ........................................................................
...   .............................................                        ........................................................................
...   .............................................                        .......................................................................
...   ............................................................................................................................................
...   ............................................................................................................................................
...   ............................................................................................................................................
